R 1000 1000

NO ./textures/brick.xpm

SO ./textures/wall.xpm

WE ./textures/monalisa.xpm

EA ./textures/wood.xpm

S ./textures/sword.xpm

F 104,65,51

C 2,31,49

11111111111111111111111111111
10000000001100000000000000001
10110000011100000020000010001
10010000000000000000000010001
10110000011100000000000010001
10000000001100000111011110201
11110111111111011100000010001
11110111111111011101010010001
11000000110101011100000010101
10002000000000001100000010001
10000000000000001101010010001
11000000110101011111011110W01
11110111111101011111011110001
11111111111111111111111111111
