R 960 400

NO ./textures/brick.xpm

SO ./textures/wall.xpm

WE ./textures/monalisa.xpm

EA ./textures/wood.xpm

S ./textures/sword.xpm

F 104,65,51

C 0,31,49

11111111111111111111111111111
10000000001100000000000000001
10110000011100000000000010001
10010000000000000000000010001
10110000011100000000000010001
10000000001100000111011110001
11110111111111011100000010201
11110111111111011101010010001
11000000110101011100000011011
10000000000000001100000011011
10000000000000001101010011011
11000000110101011111011111N11
11110111111101011111011111011
11111111111111111111111111111
